BN=0
. . . . . . . . . .
. g . . . . . . . .
. . . . . . . . . .
. . . . . . . . . .
. . . . . . . . . .
L L . . . L L L L L
. . . . . . . . . .
. . . . . . . . . .
. . . . . . . . a .
. . . . . . . . . .