BN=0
. . . . . . . . . . . . . . .
. = = = = = = . . . . . . . .
. = g . . . = . . . . . . . .
. = = = = - = - - - - - - - -
= . . . . . = . . . = . . . .
= . = = = = = . . . = . . . .
= . = . . . . . . . = . . . .
= . = . . . L L . . = . . . .
= . = . . . L L . . = . . . .
= d = = = = = = = = = . . . .
= . . - . . . . - . . . . L L
= . = = = = = . - . = = = = .
= . . L . . = . - . = . . . .
= L = = = = = . - . = . . a .
= = = . . . . . - . d . . . .