BN=0
. . . . . . . . . . . . . . .
. = = = = = = . . . . . . . . .
. = g . . . = . . . . . . . .
. = = = = . = . . . . . . . .
= . . . . . = . . . = . . . .
= . = = = = = . . . = . . . .
= . = . . . . . . . = . . . .
= . = . . . . . . . = . . . .
= . = . . . . . . . = . . . .
= . = = = = = = = = = . . . .
= . . . . . . . . . . . . . .
= . = = = = = . . . = = = = .
= . . . . . = . . . = . . . .
= . = = = = = . . . = . . a .
= = = . . . . . . . . . . . .