BN=4
g . . . . .
- - - - - -
- - - - - -
- - - - - -
- - - - - -
. . . . . a