BN=1
g . . . . . . .
. . . . . . . .
. . . . . . . .
= = = - = = = =
. . . . . . . .
. . . . . . . .
. . . . . . . .
. . . . . . . a