BN=0
. . . . . o
. . . . . .
. . . . . .
. . . . . .
. . . . . .
* . . . . a