BN=1
g . . d . .
. = = - - -
= = . . . .
. . . . . .
d = = = = =
. . . . . a