BN=0
. . . . . .
. . . . . .
a . * . . .
. . . . . .
. . . . . .
. . . . o .
