BN=2
- - - - - -
. . . . . .
- - - - - -
. . . . . .
. . . . . .
. a . g . .
