BN=0
. . . . l
. . . . .
. . . . a
. . . . .
. . . . .
