BN=1
L L . . . . = . . . . o
L . . . . . d . . L . .
. . . . . . = . . . . .
. . . . . L = . . . . .
. . . . L L = . . . . .
. . . . . . = . . . . .
. . . . . . = = = = = =
- - - - - . = . . . . .
- - - - - . = . . . . .
. . . - - . + . . L L L
- - . - - . = . . . . .
a - . - - . = . . . . *