g . . . . .
- - - - - -
. . . . . .
. . . . . .
. . . . . .
. . . . . a