g . . . . .
. . . . . .
- - - - - -
. . . . . .
. . . . . .
. . . . . a