g . . . . . . .
. . . . . . . .
. . . . . . . .
- - - - - - - -
. . . . . . . .
. . . . . . . .
. . . . . . . .
. . . . . . . a