. . . + . . . . . . . . . . .
. . . + . . . . . . . . . * .
. . . + . . . . . . . + + + +
. . o + . . . . . . . . . . .
. . . . . . . . . . . . . . .
. . . . . . . . . . . . . . .
. . . . . . . . . . . . . . .
. . . . . . . . . . . . . . .
. . . . . . . . . . . . . . .
. . . . . . . . . . . . . . .
. . . . . . . . . . . . . . .
. . . . . . . . . . . - - - -
. . . . . . . . . . . . . . .
. . . . . . . . . . . . . a .
. . . . . . . . . . . . . . .