o . . . . . . .
. . . . . . . .
. . . . . . . .
. . . . . . . .
- - - - - - - -
L L . . . . . .
d = . . . . . .
* d . . . . . a
