. . . . . . . . . . . . . . .
. = = = = = = . . . . . . . .
. = g . . . = . . . . . . . .
. = = = = - = - - - - - - - -
= . . . . . = . . . = . . . .
= . = = = = = . . . = . . . .
= . = . . . . . . . = . . . .
= . = . . . . . . . = . . . .
= . = . . . . . . . = . . . .
= d = = = = = = = = = . . . .
= . . - . . . . - . . . . . .
= . = = = = = . - . = = = = .
= . . . . . = . - . = . . . .
= . = = = = = . - . = . . a .
= = = . . . . . - . d . . . .