. . . . . . . . . .
. g . . . . . . . .
. . . . . . . . . .
. . . . . . . . . .
- - - - - - - - - -
. . . . . . . . . .
. . . . . . . . . .
. . . . . . . . . .
. . . . . . . . a .
. . . . . . . . . .