BN=1
g . . . . .
. . . . . .
= = - = = =
L L . . L L
. . . . . .
. . . . . a