. . . . . . . . . .
. g . . . . . . . .
. . . . . . . . . .
. . . . . . . . . .
+ + + + + . + + + +
. . . . . . . . . .
. . . . . . . . . .
. . . . . . . . . .
. a . . . . . . . .
. . . . . . . . . .
