. . . . . . . . . .
. g . . . . . . . .
. . . . . . . . . .
. . . . . . . . . .
- - - - . - - - - -
. . . . . . . . . .
. . . . . . . . . .
. . . . . . . . . .
. . a . . . . . . .
. . . . . . . . . .
