. . . . . . . . . .
. . . . . g . . . .
. . . . . . . . . .
. . = = = = = = . .
. . = . . . . = . .
. . = . . a . = . .
. . = . . . . = . .
. . = + + + + = . .
. . . . . . . . . .
. . . . . . . . . .