. . . . . . . . . .
. . . . . g . . . .
. . . . . . . . . .
. . = = = + = = . .
. . = . . . . = . .
. . = . . a . = . .
. . = . . . . = . .
. . = . . . . = . .
. . . . . . . . . .
. . . . . . . . . .