g . . . . . . . . .
. . . . . . . . . .
. . . . . . . . . .
. . . . . . . . . .
- - - - - - - - - -
. . . . . . . . . .
. . . . . . . . . .
. . . . . . . . . .
. . . . . . . . . .
. . . . . . . . . a