g . d . . .
. . = . . .
- - - - - -
. . . . . .
d = = = = =
. . . . . a